111111111111111111111111111111
wwwwwwwwwwwwwwwwwwwwwwwwwwwwww
w0000bb0000b0000bb000000bb00bw
w0wbw0w0w0w0w0wbw0w0w0wbw0w00w
w00bbb0000000wb0000b00bb0000bw
w0w0wbw0w0w0wbw0w0wbw0w0w0wb0w
w00bb00000ww00000bb00000000bbw
w0w0w0wbw0wbw0w0w0w0w0wbw0w00w
w00bbb0000000000bbwb000000bbbw
wbw0w0w0w0wbw0w0w0w0w0w0wbw0bw
w000bb0000000wbb00000000bb000w
wbw0w0w0wbw0w0w0w0wbw0wbw0wb0w
w00wbb00000bbbb00000000b0000bw
w0w0w0wbw0w0w0wbw0w0w0w0wbw00w
wwwwwwwwwwwwwwwwwwwwwwwwwwwwww




