111111111111111
w0000w0bbb0000w
w00b0b0w00bwb0w
w0000wbww00b00w
wbwbb00b00w0b0w
w00www0bbb0000w
w00bbbwwbbb000w
w0000000000000w
w00wwbbbb00000w
wbb0bbbbww0000w
w00wb00bbb0w00w
w00wbb0bb00w00w
w00bww0bbb0000w
w00www0bbb0000w
wwwwwwwwwwwwwww



