1111111111111111111111111111111111111111111111
wwwwwwwwwwwwwwwwwwwwwwwwwwwwwwwwwwwwwwwwwwwwww
w0000000000000000000000000000000000000000000bw
w0wbw0w0w0w0w0wbw0w0w0wbw0w000000000000000000w
w00bbb0000000wb0000b00bb00000000000000000000bw
w0w0wbw0w0w0wbw0w0wbw0w0w0wb00000000000000000w
w00bb00000ww00000bb00000000bb0000000000000000w
w0w0w0wbw0wbw0w0w0w0w0wbw0w000000000000000000w
w00bbb0000000000bbwb0000000000000000000000bbbw
wbw0w0w0w0wbw0w0w0w0w0w0w0000000000000000bw0bw
w000bb0000000wbb00000000bb0000000000000000000w
wbw0w0w0wbw0w0w0w0wbw0wbw0wb00000000000000000w
w00wbb00000bbbb00000000b00000000000000000000bw
w0w0w0wbw0w0w0wbw0w0w0w0wbw000000000000000000w
wwwwwwwwwwwwwwwwwwwwwwwwwwwwwwwwwwwwwwwwwwwwww




