11111111111111111111
wwwwwwwwwwwwwwwwwwww
w000000bb00b0000bb0w
w0wbw0w0w0w0w0w0w0ww
w00bbb00000bbb00b00w
w0w0wbw0w0w0wbw0wbbw
w00bb00bbb0000bbb00w
w0w0w0wbw0wbw0wbw00w
w00bbb00000000bb000w
wbw0w0w0w0wbw0wbw0bw
w000bb00000bbb00bb0w
wbw0w0w0wbw0w0w0w00w
w000bb00000bbbb0000w
w0w0w0wbw0w0w0w0wb0w
wwwwwwwwwwwwwwwwwwww



