111111111111111
wwwwwwwwwwwwwww
w0000000000000w
w0wbw0w0w0w0w0w
w00bbb00000bbbw
w0w0wbw0w0w0wbw
w00bb00bbb0000w
w0w0w0wbw0wbw0w
w00bbb00000000w
wbw0w0w0w0wbw0w
w000bb00000bbbw
wbw0w0w0wbw0w0w
w000bb00000bbbw
w0w0w0wbw0w0w0w
wwwwwwwwwwwwwww




